?PPPPPPPP??????????PPPPPPP??????????????????????????????PPPPPPPPPPPPPPPPP??????PPPPP????PPPPP?PPPPP?
PPPPPPPPPPPPPPPPPPPPPPPPPPPPPPPPPPPPPPPPPPPPPPPPPPPPPPPPPPPPPPPPPPPPPPPPPPPPPPPPPPPPPPPPPPPPPPPPPPPP
PPPPPPPPPPPPPPPPPPPPPPPPPPPPPPPPPPPPPPPPPPPPPPPPPPPPPPPPPPPPPPPPPPPPPPPPPPPPPPPPPPPPPPPPPPPPPPPPPPPP
PPPTTTSSTTTSSTTTTTTTTTTTTTSSTTTTTTTTTTTTTTTTTTTTTTTTTTTTTTTTTTSSTTTTAATTTTTTTTTTTTTTTTTTTTSSTTTTKPPP
PPPTTTSSTTTTSSTTTTTTTTTTTTSSTTTTTTTTTTTTTTTTTTTTTTTTTTTTTTTTTTTSSTTAATTTTTTTTTTTTTTTTTTTTSSTTTTTTPPP
PPPTTTTSSTTSSTTTTTTTTTTTTTTSSTTTTTTTTTTTTTTTTTTTTTTTTTTTTTTTTTBSSBBAABBBTTTTTTTTTTTTTTTTTSSTTTTTKPPP
?PPTTTTSSTSSTTTTTTTTTTTTTTTSSTTTTTTTTTTTTTTTTTTTTTTTTTTTTTTTTTSSSSBBAABBTTTTTTTTTTTTTTTTTSSTTTTTTPPP
?PPTTTTSSTTSSTTTTTTTTTTTTTTTSSTTTTTTTTTTTTTTTTTTTTTTTTTTTTTTTTBSSBBAABBBTTTTTTTTTTTTTTTTTSSTTTTTTPPP
PPPSTTSSTTTSSTTTTTTTTTTTTTTTSSTTTTTTTTTTTTTTTTTTTTTTTTTTTTTTTTSSBBAABBBBTTTTTTTTTTTTTTTTTTSSTTTTTPPP
PPPSSTTSSTSSSSSSTTTTTTTTTTTTTSSTTTTTTTTTTTTTTTTTTTTTTTTTTTTBBBBSSAABBBBSSSSSSSSSSSSSSTTTTTTSSTTTTPPP
PPPTSSSSSSSSSSSSSSTSTSTTTTTTTTSSTTTTTTTTTTTTTTTTTTTTTTTTTTTBBBBBSSBBBBBSSSSSSSSSSSSSSTTTTTTSSTTTTPPP
PPPTTSSTTSSSTTTTSSSSSSSSSTTTTTSSTTTTTTTTTTTTTTTTTTTTTTTTTTTBBBBSSAABBBBSSSSSSSSSSSSSSBBTTTTSSTTTTPPP
PPPTTTSSTTTSSTTTTTSTSTSSSSSTTSSTSTTTTTTTTTTTTSSTTTTTTTTTTTTBBBBBS??BBBBSSSSSSSSSSSSSSBBTTTTSSTTTTPPP
PPPTTTSSTTSSTTTTTTTTTTTTTSSSTTSSSSTTTTTSTTTTSSSSKTTTTTTTTTTBBBBSS??BBBBSSSSSSSSSSSSSSBBTTTTSSTTTTPPP
PPPTTSSTTSSTTTTTTTTTTTTTTTTSSSSSTSSTTTSSSSTSSTTSSSTTTTTTTTTBBBBBS??BBBBSSSSSSSSSSSSSSBBTTTSSTTTTTPPP
?PPTTSSTSSTTTTTTTTTTTTTTTTTTSSTTTTSSTSSTSSSSTTTTSSSSSTSTTTTBBBBSS??BBBBSSSSSSSSSSKSSSBBTTTTSSTTTTPPP
?PPTTTSSSSTTTTTTTTTTTTTTTSSSSSSSSSSSSSSTTTSTTTTTTTSSSSSSTTTBBBBSS??BBBBSSSSSSSSSSSSSSBBTTTSSTTTTTPPP
?PPTTTTSSTTTTTTTTTTTTTTTTSSSSSSSSSSSSSSTTTTTTTTTTTTTTSTSSSTBBBBSSSSBBBBSSSSSSSSSSSSSSBBTTTTSSTTTTPPP
PPPTTTSSSSTTTTTTTTTTTTTTTSSSSSSSSSSSSSSTTTTTTTTTTTTTTTTTSSSBBBBBSSBBBBBSSSSSSSSSSSSSSBBTTTTSSTTTTPPP
PPPTTTTTSSTTTTTTTTTTTTTTTSSSSSSSSSSSSSKTTTTTTTTTTTTTTTTTTTSSBBBSSSBBBBKSSSSSSSSSSSSSSBBTTTTTSTSTTPPP
PPPTTTTSSSSTTTTTTTTTTTTTTSSSSSSSSSSSSSSTTTTTTTTTTTTTTTTTTTTSSBSSSSSBBBBSSSSSSSSSSSSSSBBTTTSSSSSSTPPP
PPPTTTSSSSTTTTTTTTTTTTTTTSSSSSSSSSSSSSSTTTTTTKTTTTTTTTTTTTTBSSSBSSSSSBBSSSSSSSSSSSSSSSSSSSSSTSTSSPPP
PPPTTTTSSSSTTTTTTTTTTTTTTSSSSSSSSSSSSSSTTTTTTTTTTTTTTTTTTTTBBSBBBSSSSSSSSSSSSSSSSSSSSSMMMMSTSSTTSPPP
PPPTTTTSSTSSTTTTTTTTTTTTTSSSSSSSSSSSSSSTTTTTTTTTTTTTTTTTTTTBBBBBAASSBSSSSSSSSSSSSSSSBSMSSSSSSSTSTPPP
PPPSSSSSSSSSSSSSSSSSKTTTTSSSSSSSSSSSSSSTTTTTTTTTTTTTTTTTTTTBBBBAABBSSSBSSSBBSSSSBBSSBSMSSSTSSSSSTPPP
PPPMMMMMMMMMMMMMMMMSTTTTTSSSSSSSSSSSSSSTTTTTTTTTTTTTTTTTTTTBBSSBAASSSSBBBBBBBBBBBBBBBSMSSSTTSSSTTPPP
PPPMSSSSSSSSSSSSSSMSTTTTTSSSSSSSSSSSSSSTTTTTTTTTTTTTTTTTTTTSSSSAASSBSBBBBBBBBBBBBBBBBSMSSSTTSSTTTPPP
?PPMSSSSSSSSSSSSSSMSTTTTTSSSSSSSSSSSSSSTTTTTTTTTTTTTTTTTSTSSSTTAATSSTTTTTTTTTTTTTTTTTSMSSSTTTSSTTPPP
????????????????SSDSSSSSSSSSSSSSSSSSSSSTTTTTTTTTTTTTTTTSSSSTTTAASSTSSTTTBBBBBBBBBBBBBSMSSSTTTTSSTPPP
????????????????SSMSSSSSSSSSSSSSSSSSSSSTTTTTTTTTTTTTTTSSTSTTTAATTSSSSTTTBBBBBBB?BBBBBSMSSSTTTTTSSPPP
????????????????SSMSSSSSSSSTTTTTTTTTTTTTTTTTTTTTTTTTTSSTTTTTTTAATTSSTTTTBBBBBBB?BBBBBSMSSSTTTTSSTPPP
????????????????SSMSSSSSSSTTTTTTTTTTTTTTTTTTTTTTTTSTSSTTTTTTTTAATSSSSTTTBBBBBBB?BBBBBSMSSSTTTTSSTPPP
????????????????SSMSSSSSSSBBBTTTTTTTTTTTTTTTTTTTTSSSSTTTTTTTTTTAATSSTTTTBBBBBBB?BBBBBSMSSSTTTTTSSPPP
????????????????SSMSSSSSSSSBBTTTTTTTTTTTTTTTTTSTSSTSTTTTTTTTTTAATSSTTTTTBBBBBBBBBBBBBSMSSSTTTTTSSPPP
????????????????SSMSSSSSSSSSSSSSSSSSSSSSSSSSTSSSSTTTTTTTTTTTTTAATSSTTTBBBBBBBBBBBBBBBSMSSSTTTTSSTPPP
????????????????SSMSSSSSMMMMMMMMMMMMMMMDSSSSSSTSTTTTTTTTTTTTTTAASSSSTTBBBBBBBBBBBBBBBSMSSSTTTTTSSPPP
????????????????SSMSSSSSMSSSSSSSSSSSSSSMSTTTSTTTTTTTTTTTTTTTTTTAATSSTTBBBBBBBBBBBBBBBSMSSSTTTTSSTPPP
????????????????SSMSSSSSMSSSSSSSSSSSSSSMSTTTTTTTTTTTTTTTTTTTTTTTAASSTTBBBBBBBBBBBBBBBSMMMMTTTSSTSPPP
?PPMSSSSSSSSSSSSSSMSSSSSMSSSSSSSSSSSSSSMSTTTTTTTTTTTTTTTTTTTTTTAASSTTTBBBBBBBBSSBBBBBSSSSSTSSSSSSPPP
PPPMSSSSSSSSSSSSSSMSSSSSMSSSSSSSSSSSSSSMSTTTTTTTTTTTTTTTTTTTTTTTTSSTTTBBBBBBBSSSSBBBBBBBTTSSSSTSSPPP
PPPMMMMMMMMMMMMMMMMSSBBSMSSSSSSSSSSSSSSMSTTTTTTTTTTTTTTTTTTTSSTTAASSTTBBSBBBSSBBSSBBBBBBTSSTTTTTTPPP
PPPSSSSSSSSSSSSSSSSSSSBSMSSSSSSSSSSSSSSMSSTTTTTTTTTTTTTTTTSSSSSSTSSSTTBSSBSSSBBBBSSSSSBSSSTTTTTTTPPP
PPPTTTBBSSBSSBBBBBBBBSSSMSSSSSSSSSSSSSSMSSTTTTTTTTTTTTTTTSSSSTSSSSTSSTSSBSSSBBBBBBSSSSSSSSTTTTTTTPPP
PPPTTTBBBBSSBSBBBSBBBSSSMSSSSSSSSSSSSSSSSSSSSSSSSSSSSSSSSSTTSTTTSSSSSSSSSSSSSBBBBBBBBBSBSSTTTTTTTPPP
?PPSTTBBBBSSSSSBSSSBSSBSMSSSSSSSSSSSSSSSMMMMMMMMMMMMMMMMSTTTTTTTTSSTTSSSSBSSSSSSBBBBBBTTSSTTTTTTTPPP
?PPSSTTTTSSSSBSSSBSSSBBSMSSSSSSSSSSSSSSSMSSSSSSSSSSSSSSMSTTTTTTTTSSTTTSBBBBBBSSSSBBBBBTTSSTTTTTTTPPP
?PPTSSSTSSSSBBBSBBBSBBBSMSSSSSSSSSSSSSSSMSSSSSSSSSSSSSSMSTTTTTTTTSSTTTBBBBBBBBBBSSBBBBTTSSTTTTTTTPPP
PPPTTSSSSTSSBBBBBBBBBBBSMSSSSSSSSSSSSSSSMSSSSSSSSSSSSSSMSTTTTTTTTSSTTTBBBBBBBBBBBSSSSBTTSSTTTTTTTPPP
PPPTTTTSTSSBBBBBBBBBBBBSMSSSSSSSSSSSSSSSMSSSSSSSSSSSSSSMSTTTTTTTSSTTTTBBBBBBBBBBBBSSSSTTSSTTTTSSTPPP
PPPTTTTTTSSBBBBBBBBBBBBSMSSSSSSSSSSSSSSSMSSSSSSSSSSSSSSMSTTTTTTTTSSTTTBBBBBBBBBBBBBBBSSTSSSSTSSSSPPP
PPPTTTTTSSBBBBBBBBBBBBBSMMMMMMMMMMMMMMMSDSSSSSSSSSSSSSSMSTTTTTTTTSSTTTTTTTTTTTTTTTTTTTSSSSSSSSTTSPPP
PPPTTTTSSSSBBBBBBBBBBBBSSSSSSSSSSSSSSSSSMSSSSSSSSSSSSSSMSTTTTTTTTTSSTTTTTTTTTTTTTTTTTTTSSSTTSTTTTPPP
?PPTTTSSSSBBBBBBBBBBBBBBSSBBBBBBBBBTTTTSMSSSSSSSSSSSSSSMSTTTTTTTTTSSTTTTTTTTTTTTTTTTTTTTSSTTTTTTTPPP
?PPTTTSSSSTTTTTTTTTBBBBSSBBBBBBBBBBTTTTSMSSSSSSSSSSSSSSMSTTTTTTTTSSTTTTTTTTTTTTTTTTTTTTTTTTTTTTTTPPP
?PPTTSSSSTTTTTTTTTTBBBSSBBBBBBBBBBBTTBBSMSSSSSSSSSSSSSSMSBBBBBBBSSTTTTTTTTTTTTTTTTTTTTTTTTTTTTTTTPPP
?PPTSSTTSSTTTTTTTKTBBBBSSSSSSSSSSSSSSSSSSSSSSSSSSSSSSSSMSBBBBBBSSAATTTTTTTTTTTTTTTTTTTTTTTTTTTTTTPPP
?PPTSSTTTSSTTTTTTTTBBBBSMMMMMMMMMMMMMMMMSSSSSSSSSSSSSSSMSBBBBBBBSSBBBBBBBBBBBBBBBBTTTTTTTTTTTTTTTPPP
?PPSSTTTTTSSTTTTTTTBBBBSMSSSSSSSSSSSSSSMSSSSSSSSSSSSSSSMSBBBBBBSSSSBBBBBBBBBBBBBBBTTTTTTTTTTTTTTTPPP
?PPTSSTTTSSTTTTTTTTBBBBSMSS??????????SSMSSSSSSSSSSSSSSSMSBBBBBBBSSSSBBBBBBBBBBBBBBTTTTTTTTTTTTTTTPPP
?PPSSTTTSSTTTTTTTTTBBBBSMSS??????????SSMSMMMMMMMMMMMMMMMSBBBBBBSSTBSSBBBBBBBBBBBBBTTTTTTTTTTTTTTTPPP
?PPSSTTTTSSTTTTTTTTBBBBSMSS??????????SSMSSSSSSSSSSSSSSSSSBBBBKSSAABBSSBBBBBBBBBBBBTTTTTTTTTTTTTTTPPP
?PPSSTTTTTSSTTTTTTTBBBBSMSS??????????SSMSBBBBBBBBBBBBBBBBBBBBBBSSAASSBBSSSSSSSSSSSSSSSSTTTTTTTTTTPPP
?PPTTTTTTTSSTTTTTTTBBBBSMSS??????????SSMSBBBBBBBBBBBBBBBBBBBBBBBSSSSBBBSSSSSSSSSSSSSSSSTTTTTTTTTTPPP
?PPTTTTTTSSTTTTTTTKBBBBSMSS??????????SSMSBBBBBBBBBBBBBBBBBBBBBBBBSSBBBBSSSSSSSSSSSSSSSSTTTTTTTTTTPPP
?PPTTTTTSSTTTTTTTTTBBBBSMSS??????????SSMSBBBBBBBBBBBBBBBBBBBBBBBSSBBBBBSSSSSSSSSSSSSSSSTTTTTTTTTTPPP
?PPTTTTTSSTTTTTTTTTBBBBSMSS??????????SSMSBBBBBBBBBBBBBBBBBBBBBBBBSSBBBBSSSSSSSSSSSSSSSSTTTTTTTTTTPPP
?PPTTTTTSSTTTTTTTTTBBBBSMSS??????????SSMSBKBBBBBBBBBBBBBBBBBBBBBBTSSBBBSSSSSSSSSSSSSSSSTTTTTTTTTTPPP
?PPTTTTTTSSTTTTTTTTTTBBSMSS??????????SSMSBBBBBBBBBBBBBBBBBBBBBBBBSSBBBBSSSSSSSSSSSSSSSSTTTTTTTTTTPPP
?PPTTTTTSSTTTTTTTTTTTBBSMSS??????????SSDSBBBBBBBBB?BBBBBBBBBBBBBSSBBBBBSSSSSSSSSSSSSSSSTTTTTTTTTTPPP
?PPTTTTSSTTTTTTTTTTTTBBSMSSSSSSSS??SSSSMSBBBBBBBBB?BBBBBBBBBBBBBBSSBBBBSSSSSSSSSSSSSSSSTTTTTTTTTTPPP
?PPTTTSSTTTTTTTTTTTTTBBSMSSSSSSSSSSSSSSMSTTTTTTTTT?TTTTTTTTTTTTTTTSSBBBSSSSSSSSSSSSSSSSTTTTTTTTTTPPP
?PPTTTTSSTTTTTTTTTTTTBBSMMMMMMMMMMMMMMMMSTTBBBBBBB?BBBBBBTTTTTTTTAASSBBSSSSSSSSSSSSSSSSTTTTTTTTTTPPP
?PPTTTTSSTTTTTTTTTTTTBBSSSSSSSSSSSSSSSSSSTTBBBBBBB?BBBBBBTTTTTTTTTAASSTSSSSSSSSSSSSSSSSTTTTTTTTTTPPP
PPPTTTTSSTTTTTTTTTTTTBSSBBBBBBBBBBBBBBBBTTTBBBBBBB?BBBBBBTTTTTTTTSSSSTTSSSSSSSSSSSSSSSSTTTTTTTTTTPPP
PPPTTTSSTTTTTTTTTTTTTBSSBBBBBBBBBBBBBBBBTTTBBBBBBB?BBBBBBTTTTTTTSSTSSTTSSSSSSSSSSSSSSSSSTTTTTTTTTPPP
PPPTTTSSTTTTTTTTTTTTTBBSSBBBBBBBBBBBBBBBTTTBBKBBBB?BBBBBBTTTTTTTTSSSSTTSSSSSSSSSSSSSSSSSSTTTTTTTTPPP
PPPTTTTSSTTTTTTTTTTKTTTTSSBBBBBBBBBBBBBBTTTBBBBBBBBBBBBBBTTKTTTTSSTSSTTSSSSSSSSSSSSSSSSTSSTTTTTTTPPP
PPPTTTSSTTTTTTTTTTTTTTTTSSBBBBBBBBBBBBBBTTTBBBBBBBBBBBBBBTTTTTTTSSAASSTTTTATATTTTTTSSTTTTSSTTTTTTPPP
?PPTTTSSATTTTTTTTTTTTTTSSBBBBBBBABAAKBBBTTTBBBBBBBBBABBBBTTKTTTSSAATTSSTAAAAAAATATSSTTTTTTSTSTTSSPPP
?PPSTASSAATTTTAATTTTTTABSSBBBBBAAAAAABBBBBBBBBBBABBAAABABAATATTATTAAASSAAASATAAAAASATAATTSSSSSSSSPPP
?PPSSASSTAAAAAAAAATTTAAASSBBABAABABBAAABBBBBBBBAAAAABAAAAAAAASSATTTAASSASTSTTTTATAAAAAATSSSSASSSSPPP
?PPTSTSSSTAAAATTAATTAATAABAAAAABBBBBBAAAABBBABAABAASBSABATTASSSSSSSATSSSSSSTTTTTTTATATSSSTTTATTSSPPP
?PPTTSSTSSTTSTTTSSSSATTBAAAABABBB??BBBBAAAAAAAASBS??SSBBBTTSSTTSSSSSSTSSSSSSTTTTSSSTSSSSTTTTTTTTTPPP
?PPTTSSTSSSSSSTSSSSSSTSBBASSSBBBBSSSSBBBBAAASABSSSBSSBBSSTSSTTTSSTTSSSSTSTTSSSBSSSSSSSBBBBTTTTTTTPPP
?PPSSSSSSTSSTSSSTTTTSSSSSBSSSSBBSSSSSSBBBSSBSBBSSSSSSBSSSSSTTTSSTTTAASTTTTTTSSSSBBBSBBBBBBTTTTTTTPPP
?PPSSSSSTTTTTTSTTTTTTSTSSSSBBSSSSBSSSSBBSSSBSBSSBSSBSSSTTSTTTTTSSTTTTSSTTTTTTTSBBBBBBBBBBBTTTTTTTPPP
?PPTTTSSTTTTTTTTTTTTTTTBBSSSSSSSSSSSSSSSSSBSSSSBBBBBBSTTTTTTTTTSSTTTSSTTTTTTTTBBBBBBBBBBBBTTTTTTTPPP
?PPTTTTSSTTTTTTTTTTTTTTBBSSSSSBBSSBBBSSSSSSSBSBBBBBBBTTTTTTTTTSSTTTTSSTTTTTTTTBBBBBBBBBBBBTTTTTTTPPP
?PPTTTSSTTTTTTTTTTTTTTTBSSBBBBBBBBBBBBBBSBSBBBBBBBBBBTTTTTTTTTSSTTTTTSSTTTTTTTBBBBBBBBBBBBTTTTTTTPPP
?PPTTTTSSKTTTTTTTTTTTTTBBSSBBBBBBBBBBBBBBBBBBBBBBBBBBTTTTTTTTTSSTTTTSSTTTTTTTTBBBBBBBBBBBBTTTTTTTPPP
?PPTTTTTSSTTTTTTTTTTTTTTSSTTTTTTTTTTTTTTTTTTTTTKTTTTTTTTTTTTTSSTTTTSSTTTTTTTTTTTTTTTTTTTTTTTTTTTTPPP
PPPTTTTSSTTTTTTTTTTTTTTTSSTTTTTTTTTTTTTTTTTTTTTTTTTTTTTTTTTTTSSTTTTTSSTTTTTTTTTTTTTTTTTTTTTTTTTTTPPP
PPPTTTTTSSTTTTTTTTTTTTTTTSSTTTTTTTTTTTTTTTTTTTTTTTTTTTTTTTTTTSSTTTTTTSSTTTTTTTTTTTTTTTTTTTTTTTTTTPPP
PPPTTTTSSTTTTTTTTTTTTTTTTTSSTTTTTTTTTTTTTTTTTTTTTTTTTTTTTTTTSSTTTTTTSSTTTTTTTTTTTTTTTTTTTTTTTTTTTPPP
PPPTTTSSTTTTTTTTTTTTTTTTTTSSTTTTTTTTTTTTTTTTTTTTTTTTTTTTTTTSSTTTTTTTTSSTTTTTTTTTTTTTTTTTTTTTTTTTTPPP
PPPTTTTSSTTTTTTTTTTTTTTTTSSTTTTTTTTTTTTTTTTTTTTTTTTTTTTTTTTSSTTTTTTTAASSTTTTTTTTTTTTTTTTTKTTTTTTTPPP
PPPTTTTTSSTTTTTTTTTTTTTTTTSSTTTTTTTTTTTTTTTTTTTTTTTTTTTTTTTTSSTTTTTAASSTTTTTTTTTTTTTTTTTTTTTTTTTTPPP
PPPPPPPPPPPPPPPPPPPPPPPPPPPPPPPPPPPPPPPPPPPPPPPPPPPPPPPPPPPPPPPPPPPPPPPPPPPPPPPPPPPPPPPPPPPPPPPPPPPP
PPPPPPPPPPPPPPPPPPPPPPPPPPPPPPPPPPPPPPPPPPPPPPPPPPPPPPPPPPPPPPPPPPPPPPPPPPPPPPPPPPPPPPPPPPPPPPPPPPPP
?PPPPPP????????PPPPP???????????????????????????????????????????????PPPPP???????PPPPPPP????????PPPPP?
